NO ./textures/wall/NWall.xpm

SO ./textures/wall/SWall.xpm

EA ./textures/wall/EWall.xpm

WE ./textures/wall/WWall.xpm

F 43,36,46

C 255,0,255

11111111111111111111111111111111
1000000000000000000000000000W001
11111011111111111111111111111001
10001010000000000000000000001001
10101010111111111111111111101001
10001010000000000000100000101001
11111010111110111110101110101101
10000010000100100000101000001001
10111111110110111111101111101001
10000000000100100000001000001001
11111111110111101111111011111001
1C000000000000001000000000000C01
11101111111111110111111111101101
10001000000000000000100000001001
10111011111111111110101111111001
10000000000000000000100000000L01
10111111111101111111111111111001
10000000000001000000000000000001
11111111111111111111111111111111
