NO ./textures/wall/NWall.xpm

SO ./textures/wall/SWall.xpm

EA ./textures/wall/EWall.xpm

WE ./textures/wall/WWall.xpm

F 43,36,46

C 255,0,255

11111111111111111111111111111111
10000000000000010000000000000001
10N11111111111010111111111111001
10000000000000010100000000001001
11111101111111110101111111101001
10000001000000000101000000001001
10111111011111111101111110111001
10000000010000000000000010001001
11111111010111111111101010101001
1C000000101000000001010100001001
10111111010101111110101011111001
10000000010101000000101000000001
11110111111101011111101111101101
10000100000001010000001000001001
10111101111111010111111011101001
10000001000000010000000000100L01
10111111101111110111111111111001
10000000000000000000000000000001
11111111111111111111111111111111
