NO ./textures/wall/NWall.xpm

SO ./textures/wall/SWall.xpm

EA ./textures/wall/EWall.xpm

WE ./textures/wall/WWall.xpm

F 43,36,46

C 255,0,255

11111111111111111111111111111111
10000000000000000000000000000001
10N11110111100001111100011100001
10000010100000001000100010000001
11111010101111101010111010111101
10000000101000101010001010000001
10111110101010101011101010111001
10000010101010101000001010001001
11101010101010101111111010101001
10001010001010100000001010001001
10111011101010101111101011111001
10000000001010000000101000000001
11111111101011111110101111111101
10000000001000000000100000000001
10101111111101111111111111011101
100010000000000C0000000000001001
10111011111101111111111111011001
1000000000000100000000000000L001
11111111111111111111111111111111
