NO ./textures/wall/NWall.xpm

SO ./textures/wall/SWall.xpm

EA ./textures/wall/EWall.xpm

WE ./textures/wall/WWall.xpm

F 43,36,46

C 255,0,255

11111111111111111111111111111111
10000000000001000000000000000001
10111111111001011111111111111001
10001000001001000000000000001001
10101011101001111111101111101001
10W01000101000000100001000001001
10111010101111110101111011111001
10000010100000010100000010000001
11111110111111010111111110111101
1C000000000000101000000000000C01
11111101111111010111111111101101
10000001000000010001000000001001
10111111011111110101011111101001
10001000010000000101000000001001
10101111110111111101111111011001
1000100000001000000000000000L001
10111011111011111111111111111001
10000000000000000000000000000001
11111111111111111111111111111111
