NO ./textures/wall/NWall.xpm

SO ./textures/wall/SWall.xpm

EA ./textures/wall/EWall.xpm

WE ./textures/wall/WWall.xpm

F 43,36,46

C 255,0,255

11111111111111111111111111111111
1E000000000000000000000000000001
10111111111111111111111111111001
10000000000000000000000000001001
11111111101111111111111011101001
10000000101000000000101000101001
10111010101111111110101110101001
10001010100000000000100000101001
10101010111111111111111110101001
10001010000000000000000000101001
10111010111111111111111011101001
10000010100000000000001000001001
11111010101111111111101011111001
10001010100000000000101000000001
10101010111111111110101111111101
10001010000000000000100000000L01
10111011111111111111111111111101
10000000000000000000000000000001
11111111111111111111111111111111
