NO ./textures/wall/NWall.xpm

SO ./textures/wall/SWall.xpm

EA ./textures/wall/EWall.xpm

WE ./textures/wall/WWall.xpm

F 43,36,46

C 255,0,255

11111111111111111111111111111111
1S000001000000000000001000000001
10111110101111101111101011111001
10000000101000101000001000001001
11111011101010101011101111101001
10001000001010101010000000101001
10101111111010101111111110101001
10001000000010100000000010100001
11101011111010111111111010111101
10001010001010000000001010000001
10111010101011111111101010111001
10000010101000000000001010001001
11111110101111111111111010101001
1C000000010000000000000010000C01
10111111111111101111111111111001
10000000000000101000000000001001
11111111111010101111101111101001
1000000000000010000000000000L001
11111111111111111111111111111111
