NO ./textures/wall/NWall.xpm

SO ./textures/wall/SWall.xpm

EA ./textures/wall/EWall.xpm

WE ./textures/wall/WWall.xpm

F 43,36,46

C 255,0,255

11111111111111111111111111111111
100000000000E0000000000000000001
10111111111111111111111111111001
10000000001000000000010000001001
11111111001011111111010011101001
10000001001010000001010010001001
10111001001010111101011110101001
10001001000010100001000000101001
11101001111110101111011111101001
10001000000000100000000000001001
10101111111011111111111111111001
10000000001000000000000010000001
11111110101111111111111010111101
10000000100000000000100010000001
11111111111101111111101111111001
10000000000001000000001000000L01
11111111111111101011111111111001
1C000000000000010000000000000C01
11111111111111111111111111111111
