NO ./textures/wall/NWall.xpm

SO ./textures/wall/SWall.xpm

EA ./textures/wall/EWall.xpm

WE ./textures/wall/WWall.xpm

F 43,36,46

C 255,0,255

11111111111111111111111111111111
1E000000000100000000000000000001
11101111101011111111111111111001
10001000001000000000100000001001
10111011111101111110101111101001
10000010000001000000101000001001
10111110111001011110101111101001
10000000100001010000100000001001
11101110101111011111101110111001
10001000101000010000001010000001
10111010101111110111111010111001
10000010100000000000000010001001
11111010101111111111111010101001
10001000001000000000100000101001
10101111111011111110101111101001
10001000000010000000100000000L01
10111011111010111111101111111001
10000000000010000000000000000001
11111111111111111111111111111111
