NO ./textures/wall/NWall.xpm

SO ./textures/wall/SWall.xpm

EA ./textures/wall/EWall.xpm

WE ./textures/wall/WWall.xpm

F 43,36,46

C 255,0,255

11111111111111111111111111111111
1S000000000000000000000000000001
10111111111111111111111111111001
10000000000000000000000000001001
11111111111101111111111011101001
1C000000001010000000010001000001
11111111001101011111001101111101
10000001000001010001001010000001
10111101011111010101011110111001
10001001000000010100000000001001
10101001111111110111111111101001
10001000000000000100000000001001
10101111111111011101111111111001
10000000000001000001000000001001
11111110111101011111011111011001
10000010100001010000001000000001
10111011101111010111101011111001
1000000000000001000000000000L001
11111111111111111111111111111111
