NO ./textures/wall/NWall.xpm

SO ./textures/wall/SWall.xpm

EA ./textures/wall/EWall.xpm

WE ./textures/wall/WWall.xpm

F 43,36,46

C 255,0,255

11111111111111111111111111111111
1000000000000000000000000000W001
11111011111111111111111111111001
10001010000000000000000000001001
10101010111110111110111110101001
10001010000100100000100000101001
11111010110110101111101110101101
10000010100100101000001000001001
10111110111110101111111011111001
10000000000000100000000000000001
11111101111111110111111111111101
1C000001000000000100000000000C01
11101110101111111110111111011101
10001000101000000000100001000001
10111010101011111111101010111001
10000010100000100000001010000L01
11111011111110101111111011111101
10000000000000000000000000000001
11111111111111111111111111111111
