NO ./textures/1.xpm

SO ./textures/2.xpm

WE ./textures/3.xpm

EA ./textures/4.xpm

F 255,255,252

C 0,0,0

111111111111111111111111111111
100000000000000000000000000001
100000000000000000000000000001
100000000000000000000000000001
100000000000000000000000000001
100000000000000000000000000001
1000000000000N0000000000000001
100000000000000000000000000001
100000000000000000000000000001
100000000000000000000000000001
100000000000000000010000000001
100000000000000000010000000001
100000000000000000010000000001
100000000000000000010000000001
100000000000000000010000000001
111111111111111111111111111111
