NO ./textures/1.xpm

SO ./textures/2.xpm

WE ./textures/3.xpm

EA ./textures/4.xpm

F 112,200,0

C 10,50,200


111111111111111111111111111111
1000000000000000000100000000N1
100000000000000000010001010101
100000000000000000010001010111
100000000000000000010001010001
100000000000000000010001011111
101111111111100000011101000001
1010000000000000000C0001111111
101011111111111111110100000001
101010000010000000000100000001
101010001010111111111100000001
1010100010100000000C0000000001
101010001011111011110000000001
101010001000001011010000000001
100000001111100000010000000001
111111111111111111111111111111
