NO ./textures/wall.xpm

SO ./textures/wall.xpm

WE ./textures/wall.xpm

EA ./textures/wall.xpm

F 0,255,255

C 0,255,255


111111111111111111111111111111
100000000000000000010000000001
100000000000000000010001010101
100000000000000000010001010111
100000000000000000010001010001
100000000000000000010001011111
101111111111100000011101000001
1010000000000000000C0011111111
101011111111111111110000000001
101010000010000000000100000001
101010001010111111111100000001
1010100010100000000C0000100001
101010001011111011110000N00001
101010001000001011010000000001
100000001111100000010000000001
111111111111111111111111111111
