F 43,36,46
WE ./textures/wall/WWall.xpm
C 255,0,255
SO ./textures/wall/SWall.xpm
EA ./textures/wall/EWall.xpm
NO ./textures/wall/NWall.xpm

111111111111111 11111111111111111
100000000000001 10000010000000001
100000111100001 10000010000000001
100000100100001 10000010000000001   
100000111100001 10000010000S00001
100000000000001 1000001000CCC0001   
101111111111101 10000011100000001
101000000000001 100000C000000000L
111111111111111 11111111111111111
                                  
11111111111111 111111111111111111
10101111111111 111111110100000001
10101000001001 100000000100000001
10101000101011 111111111100000001
10101000101001 1000000C0000000001
10101000101111 111011110000000001
10101000100001 101011010000000001
10000000111111 100000010000000001
11111111111111 111111111111111111


