NO ./textures/wall/NWall.xpm

SO ./textures/wall/SWall.xpm

EA ./textures/wall/EWall.xpm

WE ./textures/wall/WWall.xpm

F    43,36,46

C    255,0,255

111111111111111111111111111111
100000000000000000010000000001
100000111100000000010000000001
100000100100000000010000000001
100000111100000000010000S00001
10000000000000000001000CCC0001
101111111111100000011100000001
1010000000000000000C000000000L
101011111111111111110100000001
101010000010000000000100000001
101010001010111111111100000001
1010100010100000000C0000000001
101010001011111011110000000001
101010001000001011010000000001
100000001111100000010000000001
111111111111111111111111111111
