
SO ./textures/wall/SWall.xpm

EA ./textures/wall/EWall.xpm


F 43,36,46

C 255,0,255
WE ./textures/wall/WWall.xpm
NO ./textures/wall/NWall.xpm

1
11111111111111111111111111111111
1000000000000000000000000000111
10000000000000000000000000000001
1000000000O0O0000000000000000001
1000000000C0C0000000000000000001
10000000111110000000000000000001
10000001  1 10000000000000000001
10000001 101 1000000000000000001
100000001 1 10000000000000000001
100C0000011100000000000000000001
10000000000000000000000000000001
10000000000000000000C00000000001
10000000000000000N0C1C00000000001
10000000000000000000C00000000001
100000000000L00000000000000000001
10000000000000000000000000000001            1111C 
10000000000000000011100000001111             1C01
10000000000000000000000000000001             1111
11111111111111111111111111111111